8 8
3 2 1 2 2 3 2 1
1 2 2 3 1 1 3 3
3 2 0 1 1 2 1 2
2 2 1 1 3 3 2 2
2 3 1 2 2 3 3 3
2 2 2 1 3 0 3 3
1 2 1 3 1 1 3 2
2 3 2 3 2 1 2 3
DYNAMIC_OBSTACLES
0 3 1
0 1 6
1 3 2
1 2 6
2 3 3
2 3 6
3 4 6
3 3 4
4 3 5
