20 20
2 2 2 2 2 5 2 2 2 2 1 2 2 2 2 5 2 2 2 2
2 2 2 2 2 5 2 2 2 2 1 2 2 2 2 5 2 2 2 2
2 2 2 2 2 5 2 2 2 2 1 2 2 2 2 5 2 2 2 2
2 2 2 0 0 5 2 2 2 2 1 2 2 2 2 5 2 2 2 2
2 2 2 0 0 5 2 2 2 2 1 2 2 2 2 5 2 2 2 2
2 2 2 2 2 5 2 2 2 2 1 2 2 2 2 5 2 2 2 2
2 2 2 2 2 5 2 2 2 2 1 2 2 2 2 5 2 2 2 2
2 2 2 2 2 5 2 2 2 2 1 2 0 2 2 5 2 2 2 2
2 2 2 2 2 5 2 2 3 3 3 3 3 0 2 5 2 2 2 2
2 2 2 2 2 5 2 2 3 3 3 3 3 2 0 5 2 2 2 2
1 1 1 1 1 5 1 1 3 3 3 3 3 1 1 5 1 1 1 1
2 2 2 2 2 5 2 2 3 3 3 3 3 2 2 5 2 2 2 2
2 2 2 2 2 5 2 2 3 3 3 3 3 2 2 5 2 2 2 2
2 2 2 2 2 5 2 2 2 2 1 2 2 2 2 5 2 2 2 2
2 2 2 2 2 5 2 2 2 2 1 2 2 2 2 5 2 2 2 2
2 2 2 2 2 5 2 2 2 2 1 2 2 2 2 0 0 2 2 2
2 2 2 2 2 5 2 2 2 2 1 2 2 2 2 0 0 2 2 2
2 2 2 2 2 5 2 2 2 2 1 2 2 2 2 5 2 2 2 2
2 2 2 2 2 5 2 2 2 2 1 2 2 2 2 5 2 2 2 2
2 2 2 2 2 5 2 2 2 2 1 2 2 2 2 5 2 2 2 2
DYNAMIC_OBSTACLES
