10 10
2 1 1 2 3 1 2 1 3 2
1 1 2 3 1 2 1 3 2 1
1 2 0 0 2 1 3 2 1 1
2 3 0 2 1 3 2 1 1 2
3 1 2 1 3 2 1 1 2 1
1 2 1 3 2 0 0 2 1 1
2 1 3 2 1 0 2 1 1 2
1 3 2 1 1 2 1 1 0 3
3 2 1 1 2 1 1 0 3 1
2 1 1 2 1 1 2 3 1 2
DYNAMIC_OBSTACLES
