5 5
1 1 1 1 1
1 3 0 1 1
1 0 2 1 1
1 1 1 4 1
1 1 1 1 1
DYNAMIC_OBSTACLES
